-----------------------------------------------------
-                                                   -
-                                                   -
-                                                   -
-            --                                     -
-=                                          +       -
--                                         --       -
-    .                                              -
--                          ----     ---            -
-                                                   -
-                              -                    -
-      ---                         -       .        -
-                                      -            -
-   -------         ----                  --        -
-                                              -    -
-        ------                   -                 -
-                                    --           - -
-                                                   -
@             ,                              --     -
-----------------------------------------------------