-----------------------------------------------------
-                                                   -
-                                                   -
-                                                   -
-            --                                     -
-                                                   -
--                                                  -
-                                                   -
--                          ----     ---            -
-                                                   -
-                                                   -
-      ---                                          -
-                                                   -
-   -------         ----                            -
-                                                   -
-        ------                   -                 -
-                                    --             -
-                                                   -
@                                                   -
-----------------------------------------------------
