------------------------------------------------------
-                                                    -
-                                                    -
-     ----        -----                              -
--    -                    -                         -
-     -     ----       .   -             --          -
-    --     -              -                         -
-     -     -          -----                         -
--    -     -                    --                  -
-     -     -                            --          -
-    --     -                                  -     -
-     -------                      --          -     -
--    -   -       ,                            -     -
-     -   -   ----------------------------------     -
-    --   -                                          -
-     -   -                                          -
--    -   -     .                     --              -
-     -   -                                    --    -
@   = - +                                            -
------------------------------------------------------